{
  "map" : [
    [" ", " ", " ", " ", " ", " ", " ", " ", " ", " ", " ", " ", " ", " ", " ", " ", " ", " ", " ", " ", " ", " ", " ", " "],
    [" ", " ", " ", " ", " ", " ", " ", " ", " ", " ", " ", " ", " ", " ", " ", " ", " ", " ", " ", " ", " ", " ", " ", " "],
    [" ", " ", " ", " ", " ", " ", " ", " ", " ", " ", " ", " ", " ", " ", "3", " ", " ", " ", " ", " ", " ", " ", " ", " "],
    [" ", " ", " ", " ", " ", " ", " ", " ", " ", " ", " ", " ", " ", " ", " ", " ", " ", " ", " ", " ", " ", " ", " ", " "],
    [" ", " ", " ", " ", " ", " ", " ", " ", " ", " ", " ", " ", " ", " ", " ", " ", " ", " ", " ", " ", " ", " ", " ", " "],
    [" ", "1", " ", " ", " ", " ", " ", " ", " ", " ", " ", " ", " ", " ", " ", " ", " ", " ", " ", " ", " ", " ", " ", " "],
    [" ", " ", " ", " ", " ", " ", " ", " ", " ", " ", " ", " ", " ", " ", " ", " ", " ", " ", " ", " ", " ", " ", " ", " "],
    [" ", " ", " ", " ", " ", " ", " ", " ", " ", " ", " ", " ", " ", " ", " ", " ", " ", " ", " ", " ", " ", " ", " ", " "],
    [" ", " ", " ", " ", " ", " ", " ", " ", " ", " ", " ", " ", " ", " ", " ", " ", " ", " ", " ", " ", " ", " ", " ", " "],
    [" ", " ", " ", "S", " ", "S", " ", " ", "S", " ", " ", " ", " ", " ", " ", " ", " ", " ", " ", " ", " ", " ", " ", " "],
    [" ", " ", "S", " ", "S", "S", " ", " ", "S", " ", "S", " ", " ", " ", " ", " ", " ", " ", " ", " ", " ", " ", " ", " "],
    [" ", " ", "S", " ", "S", "S", "S", " ", "S", "S", " ", "S", " ", " ", " ", " ", " ", " ", " ", " ", " ", " ", " ", " "],
    [" ", " ", "S", " ", "S", "S", " ", "S", "S", "S", "S", " ", " ", " ", " ", " ", " ", " ", " ", " ", " ", " ", " ", " "],
    [" ", " ", "S", " ", "S", "S", " ", " ", "S", "S", " ", " ", " ", " ", " ", " ", " ", " ", " ", " ", " ", " ", " ", " "],
    [" ", " ", " ", "S", " ", "S", " ", " ", "S", " ", "S", "S", " ", " ", " ", " ", " ", " ", " ", " ", " ", " ", " ", " "],
    [" ", " ", " ", " ", " ", " ", " ", " ", " ", " ", " ", " ", " ", " ", " ", " ", " ", " ", " ", " ", " ", " ", " ", " "],
    [" ", " ", " ", " ", " ", " ", " ", " ", " ", " ", " ", " ", " ", " ", " ", " ", " ", " ", " ", " ", " ", " ", " ", " "],
    [" ", " ", " ", " ", " ", " ", " ", " ", " ", " ", " ", " ", " ", " ", " ", " ", " ", " ", " ", " ", " ", " ", " ", " "],
    [" ", " ", " ", " ", " ", " ", " ", " ", " ", " ", " ", " ", " ", " ", " ", " ", " ", " ", " ", " ", " ", " ", " ", " "],
    [" ", " ", " ", " ", " ", " ", " ", " ", " ", " ", " ", " ", " ", " ", " ", " ", " ", " ", " ", " ", " ", " ", " ", " "]
  ],

  "obstacles" : [
    ["T", "T", "T", "T", "T", "T", "T", "T", "T", "T", "T", "T", "T", "T", "T", "T", "T", "T", "T", "T", "T", "T", "T", "T"],
    ["T", "T", "T", "T", "T", " ", " ", " ", " ", " ", " ", " ", " ", "T", "T", "T", " ", " ", " ", " ", " ", " ", " ", "T"],
    ["T", "T", "T", "T", " ", " ", " ", " ", " ", " ", " ", " ", " ", "T", " ", "T", " ", " ", " ", " ", " ", " ", " ", "T"],
    ["T", "T", "T", "T", " ", "T", "T", "T", "T", " ", " ", " ", " ", "T", " ", "T", " ", " ", " ", " ", " ", " ", " ", "T"],
    ["T", "T", "T", " ", " ", " ", " ", " ", " ", "T", " ", " ", " ", "T", " ", "T", " ", " ", " ", " ", " ", " ", " ", "T"],
    ["T", " ", "C", " ", " ", " ", " ", " ", " ", " ", "T", " ", " ", "T", " ", "T", " ", " ", " ", " ", " ", " ", " ", "T"],
    ["T", "T", " ", " ", " ", "T", "T", "T", "T", "T", "T", "T", " ", "T", " ", "T", "T", "T", "T", "T", " ", " ", " ", "T"],
    ["T", "T", " ", " ", " ", " ", " ", "T", "T", " ", " ", " ", " ", " ", " ", "T", "T", "T", "T", " ", " ", " ", " ", "T"],
    ["T", "T", " ", " ", " ", " ", " ", " ", " ", " ", " ", " ", " ", " ", " ", "T", "T", "T", "", " ", " ", " ", " ", "T"],
    ["T", "T", "R", " ", " ", "T", " ", " ", " ", " ", "E", " ", " ", " ", " ", "T", "T", " ", " ", " ", " ", " ", " ", "T"],
    ["T", "T", " ", " ", " ", " ", " ", " ", "E", " ", " ", " ", " ", " ", " ", "T", "T", " ", " ", " ", " ", " ", " ", "T"],
    ["T", "T", " ", " ", " ", " ", " ", " ", " ", " ", " ", " ", " ", " ", " ", " ", " ", " ", " ", " ", " ", " ", " ", "T"],
    ["T", "T", " ", " ", " ", " ", "C", " ", " ", " ", " ", " ", " ", " ", " ", " ", " ", " ", " ", " ", " ", " ", " ", "T"],
    ["T", "T", " ", " ", " ", " ", " ", " ", " ", " ", " ", " ", " ", " ", " ", "T", "T", " ", " ", " ", " ", " ", " ", "T"],
    ["T", "T", " ", " ", " ", " ", " ", " ", "K", "R", " ", " ", " ", " ", "T", "T", "T", "T", " ", " ", " ", " ", " ", "T"],
    ["T", "R", " ", " ", "T", " ", " ", "R", " ", " ", " ", " ", " ", " ", "T", "T", "T", "T", " ", " ", " ", " ", " ", "T"],
    ["T", "T", "T", "T", "T", "T", "T", "T", "T", "T", "T", "T", "T", "T", "T", "T", "T", "T", "T", "T", "T", "T", "T", "T"],
    ["T", "T", "T", "T", "T", "T", "T", "T", "T", "T", "T", "T", "T", "T", "T", "T", "T", "T", "T", "T", "T", "T", "T", "T"],
    ["T", "T", "T", "T", "T", "T", "T", "T", "T", "T", "T", "T", "T", "T", "T", "T", "T", "T", "T", "T", "T", "T", "T", "T"],
    ["T", "T", "T", "T", "T", "T", "T", "T", "T", "T", "T", "T", "T", "T", "T", "T", "T", "T", "T", "T", "T", "T", "T", "T"]
  ],

  "sprites" : [
    [" ", " ", " ", " ", " ", " ", " ", " ", " ", " ", " ", " ", " ", " ", " ", " ", " ", " ", " ", " ", " ", " ", " ", " "],
    [" ", " ", " ", " ", " ", " ", " ", " ", " ", " ", " ", " ", " ", " ", " ", " ", " ", " ", " ", " ", " ", " ", " ", " "],
    [" ", " ", " ", " ", " ", " ", " ", " ", " ", " ", " ", " ", " ", " ", " ", " ", " ", " ", " ", " ", " ", " ", " ", " "],
    [" ", " ", " ", " ", " ", " ", " ", " ", " ", " ", " ", " ", " ", " ", " ", " ", " ", " ", " ", " ", " ", " ", " ", " "],
    [" ", " ", " ", " ", " ", " ", " ", " ", " ", " ", " ", " ", " ", " ", " ", " ", " ", " ", " ", " ", " ", " ", " ", " "],
    [" ", " ", "C", " ", " ", " ", " ", " ", " ", " ", " ", " ", " ", " ", " ", " ", " ", " ", " ", " ", " ", " ", " ", " "],
    [" ", " ", " ", " ", " ", " ", " ", " ", " ", " ", " ", " ", " ", " ", " ", " ", " ", " ", " ", " ", " ", " ", " ", " "],
    [" ", " ", " ", " ", " ", " ", "K", " ", " ", " ", " ", " ", " ", " ", " ", " ", " ", " ", " ", " ", " ", " ", " ", " "],
    [" ", " ", " ", " ", " ", " ", " ", "B", " ", " ", " ", " ", " ", " ", " ", " ", " ", " ", " ", " ", " ", " ", " ", " "],
    [" ", " ", " ", " ", " ", " ", " ", " ", " ", " ", " ", " ", " ", " ", " ", " ", " ", " ", " ", " ", " ", " ", " ", " "],
    [" ", " ", " ", " ", "K", " ", " ", " ", " ", " ", " ", " ", " ", " ", " ", " ", " ", " ", " ", " ", " ", " ", " ", " "],
    [" ", " ", "B", "B", " ", " ", " ", " ", " ", " ", " ", " ", " ", " ", " ", " ", " ", " ", " ", " ", " ", " ", " ", " "],
    [" ", "E", "K", "B", " ", " ", " ", "E", "B", " ", " ", " ", " ", " ", " ", " ", " ", " ", " ", " ", " ", " ", " ", " "],
    [" ", " ", " ", " ", "B", "B", " ", " ", " ", " ", " ", " ", " ", " ", " ", " ", " ", " ", " ", " ", " ", " ", " ", " "],
    [" ", " ", "B", " ", " ", " ", " ", " ", " ", " ", " ", " ", " ", " ", " ", " ", " ", " ", " ", " ", " ", " ", " ", " "],
    [" ", " ", " ", " ", " ", " ", " ", " ", " ", " ", " ", " ", " ", " ", " ", " ", " ", " ", " ", " ", " ", " ", " ", " "],
    [" ", " ", " ", " ", " ", " ", " ", " ", " ", " ", " ", " ", " ", " ", " ", " ", " ", " ", " ", " ", " ", " ", " ", " "],
    [" ", " ", " ", " ", " ", " ", " ", " ", " ", " ", " ", " ", " ", " ", " ", " ", " ", " ", " ", " ", " ", " ", " ", " "],
    [" ", " ", " ", " ", " ", " ", " ", " ", " ", " ", " ", " ", " ", " ", " ", " ", " ", " ", " ", " ", " ", " ", " ", " "]
  ]
}