{
    "map" : [
      [" ", " ", " ", " ", " ", " ", " ", " ", " ", " ", " ", " ", " ", " ", " ", " ", " ", " ", " ", " ", " ", " ", " ", " "],
      [" ", " ", " ", " ", " ", " ", " ", " ", " ", " ", " ", " ", " ", " ", " ", " ", " ", " ", " ", " ", " ", " ", " ", " "],
      [" ", " ", " ", " ", " ", " ", " ", " ", " ", " ", " ", " ", " ", " ", " ", " ", " ", " ", " ", " ", " ", " ", " ", " "],
      [" ", " ", " ", " ", " ", " ", " ", " ", " ", " ", " ", " ", " ", " ", " ", " ", " ", " ", " ", " ", " ", " ", " ", " "],
      [" ", " ", " ", " ", " ", " ", " ", " ", " ", " ", " ", " ", " ", " ", " ", " ", " ", " ", " ", " ", " ", " ", " ", " "],
      [" ", " ", " ", " ", " ", " ", " ", " ", " ", " ", " ", " ", " ", " ", " ", " ", " ", " ", " ", " ", " ", " ", " ", " "],
      [" ", " ", " ", " ", " ", " ", " ", " ", " ", " ", " ", " ", " ", " ", " ", " ", " ", " ", " ", " ", " ", " ", " ", " "],
      [" ", " ", " ", " ", " ", " ", " ", " ", " ", " ", " ", " ", " ", " ", " ", " ", " ", " ", " ", " ", " ", " ", " ", " "],
      [" ", " ", " ", " ", " ", " ", " ", " ", " ", " ", " ", " ", " ", " ", " ", " ", " ", " ", " ", " ", " ", " ", " ", " "],
      [" ", " ", " ", "S", " ", "S", " ", " ", "S", " ", " ", " ", " ", " ", " ", " ", " ", " ", " ", " ", " ", " ", " ", " "],
      [" ", " ", "S", " ", "S", "S", " ", " ", "S", " ", "S", " ", " ", " ", " ", " ", " ", " ", " ", " ", " ", " ", " ", " "],
      [" ", " ", "S", " ", "S", "S", "S", " ", "S", "S", " ", "S", " ", " ", " ", " ", " ", " ", " ", " ", " ", " ", " ", " "],
      [" ", " ", "S", " ", "S", "S", " ", "S", "S", "S", "S", " ", " ", " ", " ", " ", " ", " ", " ", " ", " ", " ", " ", " "],
      [" ", " ", "S", " ", "S", "S", " ", " ", "S", "S", " ", " ", " ", " ", " ", " ", " ", " ", " ", " ", " ", " ", " ", " "],
      [" ", " ", " ", "S", " ", "S", " ", " ", "S", " ", "S", "S", " ", " ", " ", " ", " ", " ", " ", " ", " ", " ", " ", " "],
      [" ", " ", " ", " ", " ", " ", " ", " ", " ", " ", " ", " ", " ", " ", " ", " ", " ", " ", " ", " ", " ", " ", " ", " "],
      [" ", " ", " ", " ", " ", " ", " ", " ", " ", " ", " ", " ", " ", " ", " ", " ", " ", " ", " ", " ", " ", " ", " ", " "],
      [" ", " ", " ", " ", " ", " ", " ", " ", " ", " ", " ", " ", " ", " ", " ", " ", " ", " ", " ", " ", " ", " ", " ", " "],
      [" ", " ", " ", " ", " ", " ", " ", " ", " ", " ", " ", " ", " ", " ", " ", " ", " ", " ", " ", " ", " ", " ", " ", " "],
      [" ", " ", " ", " ", " ", " ", "2", " ", " ", " ", " ", " ", " ", " ", " ", " ", " ", " ", " ", " ", " ", " ", " ", " "]
    ],
  
    "obstacles" : [
      [" ", " ", " ", " ", " ", " ", " ", " ", " ", " ", " ", " ", " ", " ", " ", " ", " ", " ", " ", " ", " ", " ", " ", " "],
      [" ", " ", " ", " ", " ", " ", " ", " ", " ", " ", " ", " ", " ", " ", " ", " ", " ", " ", " ", " ", " ", " ", " ", " "],
      [" ", " ", " ", " ", " ", " ", " ", " ", " ", " ", " ", " ", " ", "T", "T", "T", " ", " ", " ", " ", " ", " ", " ", " "],
      ["T", "T", " ", " ", " ", "T", "T", "T", "T", " ", " ", " ", " ", "T", " ", "T", " ", " ", " ", " ", " ", " ", " ", " "],
      ["T", " ", "T", " ", "T", " ", " ", " ", " ", "T", " ", " ", " ", "T", " ", "T", " ", " ", " ", " ", " ", " ", " ", " "],
      ["C", " ", "T", "T", " ", " ", " ", " ", " ", " ", "T", " ", " ", "T", " ", "T", " ", " ", " ", " ", " ", " ", " ", " "],
      [" ", " ", "T", " ", " ", "T", "T", "T", "T", "T", "T", "T", " ", "T", " ", "T", "T", "T", "T", "T", " ", " ", " ", " "],
      ["T", " ", "T", " ", " ", " ", " ", "T", "T", " ", " ", " ", "T", " ", " ", "T", "T", " ", " ", " ", " ", " ", " ", " "],
      ["T", " ", " ", " ", " ", " ", " ", " ", " ", " ", " ", " ", " ", " ", " ", "T", "T", "T", "T", " ", " ", " ", " ", " "],
      ["T", " ", "R", " ", " ", "T", " ", " ", " ", " ", "E", " ", " ", " ", " ", "T", " ", " ", " ", " ", " ", " ", " ", " "],
      ["T", " ", " ", " ", " ", " ", " ", " ", "E", " ", " ", " ", " ", " ", " ", "T", "T", " ", " ", " ", " ", " ", " ", " "],
      ["T", " ", "R", "K", " ", " ", " ", " ", " ", " ", " ", " ", " ", " ", " ", "T", "T", " ", " ", " ", " ", " ", " ", " "],
      ["R", "E", "K", " ", "E", " ", " ", " ", " ", " ", " ", " ", " ", " ", " ", "T", " ", " ", " ", " ", " ", " ", " ", " "],
      ["R", "E", " ", "R", " ", " ", " ", " ", " ", " ", " ", " ", " ", " ", " ", "T", " ", " ", " ", " ", " ", " ", " ", " "],
      ["R", " ", " ", " ", "T", "K", " ", " ", "K", "R", " ", " ", " ", " ", "T", "T", " ", " ", " ", " ", " ", " ", " ", " "],
      [" ", "R", " ", " ", "T", " ", " ", "R", " ", " ", " ", " ", " ", " ", "T", "T", " ", " ", " ", " ", " ", " ", " ", " "],
      ["T", "T", "T", "T", "T", "T", " ", "T", "T", "T", "T", "T", "T", "T", "T", "T", "T", "T", "T", "T", "T", "T", "T", "T"],
      ["T", "T", "T", "T", "T", "T", " ", "T", "T", "T", "T", "T", "T", "T", "T", "T", "T", "T", "T", "T", "T", "T", "T", "T"],
      ["T", "T", "T", "T", "T", "T", " ", "T", "T", "T", "T", "T", "T", "T", "T", "T", "T", "T", "T", "T", "T", "T", "T", "T"],
      ["T", "T", "T", "T", "T", "T", " ", "T", "T", "T", "T", "T", "T", "T", "T", "T", "T", "T", "T", "T", "T", "T", "T", "T"]
    ],
  
    "sprites" : [
      [" ", " ", " ", " ", " ", " ", " ", " ", " ", " ", " ", " ", " ", " ", " ", " ", " ", " ", " ", " ", " ", " ", " ", " "],
      [" ", " ", " ", " ", " ", " ", " ", " ", " ", " ", " ", " ", " ", " ", " ", " ", " ", " ", " ", " ", " ", " ", " ", " "],
      [" ", " ", " ", " ", " ", " ", " ", " ", " ", " ", " ", " ", " ", " ", " ", " ", " ", " ", " ", " ", " ", " ", " ", " "],
      [" ", " ", " ", " ", " ", " ", " ", " ", " ", " ", " ", " ", " ", " ", " ", " ", " ", " ", " ", " ", " ", " ", " ", " "],
      [" ", " ", " ", " ", " ", " ", " ", " ", " ", " ", " ", " ", " ", " ", " ", " ", " ", " ", " ", " ", " ", " ", " ", " "],
      [" ", " ", " ", " ", " ", " ", " ", " ", " ", " ", " ", " ", " ", " ", " ", " ", " ", " ", " ", " ", " ", " ", " ", " "],
      [" ", " ", " ", " ", " ", " ", " ", " ", " ", " ", " ", " ", " ", " ", " ", " ", " ", " ", " ", " ", " ", " ", " ", " "],
      [" ", " ", " ", " ", " ", " ", "K", " ", " ", " ", " ", " ", " ", " ", " ", " ", " ", " ", " ", " ", " ", " ", " ", " "],
      [" ", " ", " ", " ", " ", " ", " ", "K", " ", " ", " ", " ", " ", " ", " ", " ", " ", " ", " ", " ", " ", " ", " ", " "],
      [" ", " ", " ", " ", " ", " ", " ", " ", " ", " ", " ", " ", " ", " ", " ", " ", " ", " ", " ", " ", " ", " ", " ", " "],
      [" ", " ", " ", " ", "K", " ", " ", " ", " ", " ", " ", " ", " ", " ", " ", " ", " ", " ", " ", " ", " ", " ", " ", " "],
      [" ", " ", " ", " ", " ", " ", " ", " ", " ", " ", " ", " ", " ", " ", " ", " ", " ", " ", " ", " ", " ", " ", " ", " "],
      [" ", "E", "K", " ", " ", " ", " ", "E", " ", " ", " ", " ", " ", " ", " ", " ", " ", " ", " ", " ", " ", " ", " ", " "],
      [" ", " ", " ", " ", " ", " ", " ", " ", " ", " ", " ", " ", " ", " ", " ", " ", " ", " ", " ", " ", " ", " ", " ", " "],
      [" ", " ", "E", " ", " ", " ", " ", " ", " ", " ", " ", " ", " ", " ", " ", " ", " ", " ", " ", " ", " ", " ", " ", " "],
      [" ", " ", " ", " ", " ", " ", " ", " ", " ", " ", " ", " ", " ", " ", " ", " ", " ", " ", " ", " ", " ", " ", " ", " "],
      [" ", " ", " ", " ", " ", " ", " ", " ", " ", " ", " ", " ", " ", " ", " ", " ", " ", " ", " ", " ", " ", " ", " ", " "],
      [" ", " ", " ", " ", " ", " ", " ", " ", " ", " ", " ", " ", " ", " ", " ", " ", " ", " ", " ", " ", " ", " ", " ", " "],
      [" ", " ", " ", " ", " ", " ", "C", " ", " ", " ", " ", " ", " ", " ", " ", " ", " ", " ", " ", " ", " ", " ", " ", " "]
    ]
  }